14 12
##############
#            #
#   ####     #
#   #  #     #
#   # $#     #
#  ##  ##    #
#  # $  #    #
#  #  @ #    #
#  ## .##    #
#   # .#     #
#   #  #     #
##############