10 8
##########
#        #
# $  @   #
#        #
#   .    #
#   $    #
#   .    #
##########