12 10
############
#          #
#  $  @    #
#   $      #
#          #
#    .     #
#    .     #
#    .     #
#          #
############